30 15

5 5 5 5 5 5 5 5 5 5 5 5 5 1 5 5 5 5 5 5 5 5 5 5 5 5 5 5 5 5
5 5 5 5 5 5 5 5 5 5 5 2 5 5 5 5 3 5 5 5 5 5 5 5 5 5 5 5 5 5
5 5 5 5 5 5 5 5 5 5 5 5 5 5 5 5 5 5 5 5 5 5 5 5 5 5 5 5 5 7
5 5 5 5 5 5 5 2 5 4 5 5 5 5 1 5 5 5 5 5 5 5 5 5 5 5 7 7 7 7
5 5 5 5 5 1 5 5 5 5 5 5 5 5 5 5 5 5 5 5 5 5 5 5 7 7 7 7 7 7
5 5 5 5 5 5 5 5 5 5 5 5 5 5 5 5 0 5 5 5 5 5 5 7 7 7 7 7 7 7
5 5 5 5 0 5 5 3 5 5 5 0 5 5 5 5 5 5 5 5 5 5 7 7 7 7 7 7 7 7
5 5 5 5 5 5 5 5 5 5 5 5 5 4 5 5 5 3 5 2 5 7 7 7 7 7 7 7 7 7
5 5 5 5 5 5 5 5 5 5 4 5 5 5 5 5 5 5 5 5 5 7 7 7 7 7 7 7 7 7
5 5 5 5 5 5 5 5 5 5 5 5 5 5 5 5 5 5 5 5 5 7 7 7 7 7 7 7 7 7
5 5 5 5 5 5 5 5 5 5 5 5 5 5 5 5 5 5 5 5 7 7 7 7 7 7 7 7 7 7
5 5 5 5 5 5 5 5 5 5 5 5 5 5 5 5 5 5 5 7 7 7 7 7 7 7 7 0 5 7
5 5 5 5 5 5 5 5 5 5 5 5 5 5 5 5 5 5 5 7 7 7 8 8 7 7 7 5 5 7
8 8 8 8 8 8 8 8 8 8 8 8 8 8 8 8 8 8 7 7 7 7 8 8 8 8 7 7 7 7
8 8 8 8 8 8 8 8 8 8 8 8 8 8 8 8 8 7 7 7 7 8 8 8 8 8 8 7 7 7


