30 15
128 640
33 33 33 33 33 33 33 33 33 33 33 33 33 33 33 33 33 33 33 33 33 33 33 33 33 33 33 33 33 33
33 33 33 33 33 33 33 33 33 33 33 33 33 29 30 31 33 33 33 33 28 33 33 33 33 33 33 33 33 33
33 33 33 33 33 33 33 33 29 30 30 35 31 19 23 21 32 33 33 28 33 33 33 33 33 33 33 33 33 33
33 33 33 33 33 33 33 33 19 23 23 23 21 33 33 33 22 32 33 33 28 33 33 33 33 33 33 33 33 33
33 33 33 33 33 33 33 32 33 33 33 33 33 33 33 33 33 22 33 33 33 33 33 33 33 33 33 33 33 33
33 33 33 33 33 33 32 22 33 33 33 33 33 33 0 33 33 33 33 33 29 35 31 33 33 33 33 33 33 33
33 33 33 33 33 32 22 33 33 32 33 33 33 1 2 3 33 33 33 29 12 13 14 33 33 33 33 33 33 33
33 33 33 33 33 22 33 33 29 15 30 31 33 4 5 6 33 33 29 12 24 26 18 29 31 33 33 33 33 33
33 33 33 33 29 30 30 31 19 20 23 21 33 7 8 9 33 33 19 20 17 18 33 19 21 33 33 33 33 33
33 33 33 33 19 23 23 21 33 33 33 33 29 30 10 30 31 33 33 33 33 33 33 33 33 29 30 34 30 30
30 30 30 31 33 33 33 33 33 33 33 33 19 23 23 23 21 33 33 33 33 33 33 33 33 12 13 13 13 13
13 13 13 14 33 33 33 33 33 33 33 33 33 33 33 33 33 33 33 33 33 33 33 33 33 25 26 26 26 26
17 17 17 18 33 33 33 33 33 33 33 33 33 33 33 33 33 33 33 33 33 33 33 33 33 16 17 17 17 17
33 33 33 33 33 33 33 33 33 33 33 33 33 33 33 33 33 33 33 33 33 33 33 33 33 33 33 33 33 33
33 33 33 33 33 33 33 33 33 33 33 33 33 33 33 33 33 33 33 33 33 33 33 33 33 33 33 33 33 33