30 15
128 512
33 33 33 33 33 33 33 33 33 33 33 33 33 33 33 33 33 33 33 33 33 33 33 33 33 33 33 33 33 33
33 33 33 33 33 33 33 33 33 33 33 33 29 30 31 33 33 33 33 33 33 33 33 33 33 33 33 33 33 33
33 33 33 33 33 33 33 33 33 33 33 32 19 23 21 33 32 33 33 33 33 33 33 33 33 33 33 33 33 33
33 33 33 33 33 33 33 33 33 33 33 22 33 33 33 33 22 33 33 33 33 33 33 33 33 33 33 33 33 33
33 33 33 33 33 33 33 33 32 33 32 33 33 33 32 33 33 33 33 33 33 33 33 33 33 33 33 33 33 33
33 33 33 33 33 33 32 33 22 33 22 33 33 33 22 33 33 33 33 33 33 33 33 33 33 33 33 33 33 33
33 33 33 33 33 33 22 33 33 32 33 33 33 33 33 33 33 33 33 33 33 33 33 33 33 33 33 33 33 33
33 33 33 33 33 29 31 33 33 22 33 32 33 33 33 33 32 33 33 33 33 33 33 33 33 33 33 33 33 33
30 30 30 31 33 19 21 33 33 33 29 15 31 33 32 33 22 29 31 33 33 33 33 33 33 33 33 33 33 33
23 23 23 21 33 33 33 33 33 33 19 20 21 33 22 33 33 19 21 33 33 33 33 33 33 33 33 33 33 33
33 33 33 33 33 33 33 33 33 33 33 33 33 33 33 33 33 33 33 33 33 33 33 33 33 33 33 33 33 33
33 33 33 33 33 33 33 33 33 33 33 33 33 33 33 33 33 33 33 33 33 33 33 33 33 33 33 33 33 33
33 33 33 33 33 33 33 33 33 33 33 33 33 33 33 33 33 33 33 33 33 33 33 33 33 33 33 33 33 33
33 33 33 33 33 33 33 33 33 33 33 33 33 33 33 33 33 33 33 33 33 33 33 33 33 33 33 33 33 33
33 33 33 33 33 33 33 33 33 33 33 33 33 33 33 33 33 33 33 33 33 33 33 33 33 33 33 33 33 33

